    #     #                           %%%###                        %%%%                      %%%%####%%%%####                %###  %                      
    #%%%%%#                          %%%  ###                       %%%%                     %%%%####%%%%####      #         %###   %##        %%%%%       
    #%%%%%#                         %%%    ###         %%%%%%       %%%%      #### ####     %%%%####%%%%####      ###       %###     #       #### ####     
    #     #                        %%%      ###        ###%%%       %%%%      ###% %###    %%%%####%%%%####                %###      ##        %%%%%       
                                  %%%%%%%%%%%###       %%%%%%       ####      ##%% %%##   %%%%####%%%%####                %###       #                     
                                 %%%          ###          %        ####      #%%% %%%#                        # %%      %###        ##      #             
                                %%%            ###     #  %         ####      %%%% %%%%   %%%% %%%% ####                %###         #        #            
       %%%%%%                  %%%  %%%%%%%%%%% ###     #%          ####                  %%%% %%%% ####      # %%     %###         %##        %           
       %%%%%                  %%%                ###     #          %%%%                  %%%% %%%% ####              %###          %                      
       %%%%                  %%%    %%%%%%%%%%%   ###               %%%%    %%  ##  ##    %%%% %%%% ####       # %%  %###                                  # # # %%% %%% %%% # # #   *          
       %%%                  %%%                    ###              %%%%    %%  ##  ##                              %###                      %            
              #            %%%      %%%%%%%%%%%     ###          #  %%%%      %%  %%      #### #### %%%%   %%      %###        #%%           #                                        
             ##           %%%                        ###        ##  %%%%      %%  %%      #### #### %%%%  ##      %###         #%%          #              
            ###          %%%                          ###      # #  ####    ##  %%  ##    #### #### %%%%   %%    %###          %##      #                  
           ####         %%%  %%%%%%%%%%%%%%%%%%%%%%%%  ###    #  #  ####    ##  %%  ##    #### #### %%%%        %###           #%% %    ##          #########
                       %%%                              ###  ####   ####                                       %###                %    ##         %%%%%%%%%
                      %%%                      #############        ####                   ## ##  # ###  #    %###  #  #           %%#%%##%%          #  # 
%%%%%%%%%%%%%%%%%%%%%%%%                                  ##########    ###               #  #  ## #   ##    %###                   ###%%#%%        ######### 
